%%%%%%%%%%
%.  % .  %
% % % %% %
% %    % %
%  %P%   %
%.  .  . %
% %%%% % %
%. .   % %
%%%%%%%%%%