%%%%%%%%%%%%%%%%%%%%%%%%%%%%%%%%%%%%%%%%%%%%%%%%%%%%%%%%%%%%%
%         % %           %     %           %           %    .%
% %%%% %% % % %%%%% %%%%% %%% % %%%% %% %%% %% %% %%% % % % %
% %     %   %     %       %   %       %     %   % % %   % % %
% % %%% % %%%% %% %%%%%%%%% %%%%% %%% % %%% % % % % %%%%% % %
% %   %   %       %       %       %   %   % % % %     %   % %
% % %%% %%% %%% %%% % %%% %%%% %% % %%% % %%% % %%% %%% %%% %
%   %     %     %   % %         % % %   %     %   % %   % % %
% %%% %%% %%%%% %%%%% % %%% %%% %%%%% %%%%%% %%%% %%% %%% % %
%     %       %         % % %         %   %     %     %   % %
% %%%%% %%%%% %%%%% %%% % % % %%%%%%%%% % % %%% %%% %%% %%% %
% %   % %   %         % %   % %     %   % % %           %   %
% % %%% % %%% %%%%% % % %%%%% % % %%% % % %%% %%%%% %%%%% %%%
%   %   % %       % % %   %   % %   % % %     %     %   % % %
% %%% %%% % % %%% %%% %%% % %%% %%% % % %%%%%%%%% %%% % % % %
% %   %   % %   %   % %   % %     %   %   %     % %   %   % %
%   %%% % % % % % % % % %%% % %%%%%%% %%% % %%% % % %%%%%%% %
% %   % %   % %   %   % %                 % %   % % %       %
% %%% %%% %%% %%% % %%% % %%% % %%%%%% %%%% % %%%%% % % %%% %
%   %         %   % %   % %   %         %   % %     % % %   %
%%% %%% % %%%%% %%%%% %%%%% %%% %%%%%%% % %%% % %%%%%%% % %%%
%P    %       %             %         %     %           %   %
%%%%%%%%%%%%%%%%%%%%%%%%%%%%%%%%%%%%%%%%%%%%%%%%%%%%%%%%%%%%%