%%%%%%%%%%%%%%%%%%%%%%%%%%%%%%%%%%%%%
%                     %P            %
%                     %             %
%                     %             %
%                     %             %
%                     %             %
%                     %%%%%%        %
%                          %        %
%                          %        %
%                          %        %
%                          %        %
%                          %        %
%        %%%%%%%%%%%%               %
%        %                          %
%        %                          %
%        %                          %
%        %                          %
%        %                          %
%        .%                         %
%%%%%%%%%%%%%%%%%%%%%%%%%%%%%%%%%%%%%